11111111111111111111111
10000000000000000000001
10000000000000000000001
10011111110011111111111
10000000000000000000011
11111111111111111111111